21

   **************************************************************
   *............................................................*
   *............................................................*
   *............................................................*
   *............................................................*
   *............................................................*
   *............................................................*
   *............................................................*
   *............................................................*
   *..............**********************........................*                
   *............................................................*
   *............................................................*
   *............................................................*
   *............................................................*
   *..............*********************.........................*
   *............................................................*
   *............................................................*
   *............................................................*
   *............................................................* 
   **************************************************************